
;;;;;;  Base sit. WTP (Water in a Teapot on a Plate)

  sit-WTP       :  (inst-of sit-WTP situation)

  black-WTP     :  (inst-of black-WTP black)
  cause-WTP-i   :  (cause initst-WTP-2 T-of-WTP-t)
  cause-WTP-e   :  (cause interst-WTP  T-of-WTP-w)
  color-of-WTP  :  (color-of tpot-WTP black-WTP)
  endst-WTP     :  (end-state T-of-WTP-t T-of-WTP-w)
  follows-WTP   :  (follows initst-WTP-1 endst-WTP)
  goalst-WTP    :  (goal-state T-of-WTP-w high-T-WTP water-WTP)
  high-T-WTP    :  (inst-of high-T-WTP high-temp)
  hplate-WTP    :  (inst-of hplate-WTP hot-plate)
  in-WTP        :  (in water-WTP tpot-WTP)
  initst-WTP-1  :  (init-state T-of-WTP-p high-T-WTP on-WTP in-WTP)
  initst-WTP-2  :  (init-state T-of-WTP-p on-WTP tpot-WTP)
  interst-WTP   :  (inter-state T-of-WTP-t in-WTP water-WTP)
  made-of-WTP   :  (made-of tpot-WTP mmetal-WTP)
  mmetal-WTP    :  (inst-of mmetal-WTP material-metal)
  on-WTP        :  (on tpot-WTP hplate-WTP)
  T-of-WTP-p    :  (temperature-of hplate-WTP high-T-WTP)
  T-of-WTP-t    :  (temperature-of tpot-WTP high-T-WTP)
  T-of-WTP-w    :  (temperature-of water-WTP high-T-WTP)
  to-reach-WTP  :  (to-reach initst-WTP-1 goalst-WTP)
  tpot-WTP      :  (inst-of tpot-WTP teapot)
  water-WTP     :  (inst-of water-WTP water)


;;;;;;  Base sit. BF (Bowl on a Fire burns out)

  sit-BF       :  (inst-of sit-BF situation)

  bowl-BF      :  (inst-of bowl-BF bowl)
  cause-BF-b   :  (cause initst-BF-2 is-burnt-BF)
  cause-BF-d   :  (cause interst-BF  is-dissip-BF)
  endst-BF     :  (end-state is-burnt-BF is-dissip-BF)
  fire-BF      :  (inst-of fire-BF fire)
  follows-BF   :  (follows initst-BF-1 endst-BF)
  goalst-BF    :  (goal-state T-of-BF-w high-T-BF water-BF)
  high-T-BF    :  (inst-of high-T-BF high-temp)
  in-BF        :  (in water-BF bowl-BF)
  initst-BF-1  :  (init-state T-of-BF-f high-T-BF on-BF in-BF)
  initst-BF-2  :  (init-state T-of-BF-f made-of-BF mwood-BF on-BF)
  interst-BF   :  (inter-state is-burnt-BF in-BF bowl-BF)
  is-burnt-BF  :  (is-burnt-out bowl-BF)
  is-dissip-BF :  (is-dissipated water-BF)
  made-of-BF   :  (made-of bowl-BF mwood-BF)
  mwood-BF     :  (inst-of mwood-BF material-wood)
  on-BF        :  (on fire-BF bowl-BF)
  T-of-BF-f    :  (temperature-of fire-BF high-T-BF)
  T-of-BF-w    :  (temperature-of water-BF high-T-BF)
  to-reach-BF  :  (to-reach initst-BF-1 goalst-BF)
  water-BF     :  (inst-of water-BF water)


;;;;;;  Base sit. GP (Glass on a hot Plate breaks)

  sit-GP       :  (inst-of sit-GP situation)

  cause-GP-b   :  (cause initst-GP-2 is-broken-GP)
  cause-GP-d   :  (cause interst-GP  is-dissip-GP)
  endst-GP     :  (end-state is-broken-GP is-dissip-GP)
  follows-GP   :  (follows initst-GP-1 endst-GP)
  glass-GP     :  (inst-of glass-GP glass)
  goalst-GP    :  (goal-state T-of-GP-w high-T-GP water-GP)
  high-T-GP    :  (inst-of high-T-GP high-temp)
  hplate-GP    :  (inst-of hplate-GP hot-plate)
  in-GP        :  (in water-GP glass-GP)
  initst-GP-1  :  (init-state T-of-GP-p high-T-GP on-GP in-GP)
  initst-GP-2  :  (init-state T-of-GP-p made-of-GP mglass-GP on-GP)
  interst-GP   :  (inter-state is-broken-GP in-GP glass-GP)
  is-broken-GP :  (is-broken glass-GP)
  is-dissip-GP :  (is-dissipated water-GP)
  made-of-GP   :  (made-of glass-GP mglass-GP)
  mglass-GP    :  (inst-of mglass-GP material-glass)
  on-GP        :  (on hplate-GP glass-GP)
  T-of-GP-p    :  (temperature-of hplate-GP high-T-GP)
  T-of-GP-w    :  (temperature-of water-GP high-T-GP)
  to-reach-GP  :  (to-reach initst-GP-1 goalst-GP)
  water-GP     :  (inst-of water-GP water)


;;;;;;  Base sit. IHC (Immersion Heater in a Cup with water)

  sit-IHC       :  (inst-of sit-IHC situation)

  cause-IHC     :  (cause initst-IHC T-of-IHC-w)
  cup-IHC       :  (inst-of cup-IHC cup)
  endst-IHC     :  (end-state T-of-IHC-w)
  follows-IHC   :  (follows initst-IHC endst-IHC)
  goalst-IHC    :  (goal-state T-of-IHC-w high-T-IHC water-IHC)
  high-T-IHC    :  (inst-of high-T-IHC high-temp)
  imm-htr-IHC   :  (inst-of imm-htr-IHC immersion-heater)
  in-IHC-iw     :  (in imm-htr-IHC water-IHC)
  in-IHC-wc     :  (in water-IHC cup-IHC)
  initst-IHC    :  (init-state T-of-IHC-ih high-T-IHC in-IHC-iw imm-htr-IHC)
  made-of-IHC   :  (made-of cup-IHC mchina-IHC)
  mchina-IHC    :  (inst-of mchina-IHC material-china)
  on-IHC        :  (on saucer-IHC cup-IHC)
  saucer-IHC    :  (inst-of saucer-IHC saucer)
  T-of-IHC-ih   :  (temperature-of imm-htr-IHC high-T-IHC)
  T-of-IHC-w    :  (temperature-of water-IHC high-T-IHC)
  to-reach-IHC  :  (to-reach initst-IHC goalst-IHC)
  water-IHC     :  (inst-of water-IHC water)


;;;;;;  Base sit. FDO (Food on a Dish in an Oven)

  sit-FDO       :  (inst-of sit-FDO situation)

  cause-FDO-i   :  (cause initst-FDO-2 in-FDO-fo)
  cause-FDO-t   :  (cause interst-FDO  T-of-FDO-f)
  dish-FDO      :  (inst-of dish-FDO baking-dish)
  endst-FDO     :  (end-state T-of-FDO-f)
  follows-FDO   :  (follows initst-FDO-1 endst-FDO)
  food-FDO      :  (inst-of food-FDO food)
  goalst-FDO    :  (goal-state T-of-FDO-f high-T-FDO food-FDO)
  high-T-FDO    :  (inst-of high-T-FDO high-temp)
  initst-FDO-1  :  (init-state T-of-FDO-o high-T-FDO on-FDO in-FDO-do)
  initst-FDO-2  :  (init-state on-FDO in-FDO-do)
  interst-FDO   :  (inter-state in-FDO-fo T-of-FDO-o oven-FDO)
  in-FDO-fo     :  (in food-FDO oven-FDO)
  in-FDO-do     :  (in dish-FDO oven-FDO)
  on-FDO        :  (on dish-FDO food-FDO)
  oven-FDO      :  (inst-of oven-FDO oven)
  rectang-FDO   :  (inst-of rectang-FDO rectang-shape)
  shape-of-FDO  :  (shape-of dish-FDO rectang-FDO)
  T-of-FDO-o    :  (temperature-of oven-FDO high-T-FDO)
  T-of-FDO-f    :  (temperature-of food-FDO high-T-FDO)
  to-reach-FDO  :  (to-reach initst-FDO-1 goalst-FDO)


;;;;;;  Base sit. MTF (Milk in a Teapot in a Fridge)

  sit-MTF       :  (inst-of sit-MTF situation)

  cause-MTF-i   :  (cause initst-MTF-2 in-MTF-mf)
  cause-MTF-t   :  (cause interst-MTF  T-of-MTF-m)
  color-of-MTF  :  (color-of tpot-MTF green-MTF)
  endst-MTF     :  (end-state T-of-MTF-m)
  follows-MTF   :  (follows initst-MTF-1 endst-MTF)
  fridge-MTF    :  (inst-of fridge-MTF fridge)
  goalst-MTF    :  (goal-state T-of-MTF-m low-T-MTF milk-MTF)
  green-MTF     :  (inst-of green-MTF green)
  initst-MTF-1  :  (init-state T-of-MTF-f low-T-MTF in-MTF-mt in-MTF-tf)
  initst-MTF-2  :  (init-state in-MTF-mt in-MTF-tf)
  interst-MTF   :  (inter-state in-MTF-mf T-of-MTF-f fridge-MTF)
  in-MTF-mf     :  (in milk-MTF fridge-MTF)
  in-MTF-mt     :  (in milk-MTF tpot-MTF)
  in-MTF-tf     :  (in tpot-MTF fridge-MTF)
  low-T-MTF     :  (inst-of low-T-MTF low-temp)
  milk-MTF      :  (inst-of milk-MTF milk)
  T-of-MTF-f    :  (temperature-of fridge-MTF low-T-MTF)
  T-of-MTF-m    :  (temperature-of milk-MTF low-T-MTF)
  to-reach-MTF  :  (to-reach initst-MTF-1 goalst-MTF)
  tpot-MTF      :  (inst-of tpot-MTF teapot)


;;;;;;  Base sit. ICF (Ice Cube in a Fridge)

  sit-ICF       :  (inst-of sit-ICF situation)

  cause-ICF-i   :  (cause initst-ICF-2 in-ICF-if)
  cause-ICF-t   :  (cause interst-ICF  T-of-ICF-i)
  endst-ICF     :  (end-state T-of-ICF-i)
  follows-ICF   :  (follows initst-ICF-1 endst-ICF)
  fridge-ICF    :  (inst-of fridge-ICF fridge)
  glass-ICF     :  (inst-of glass-ICF glass)
  goalst-ICF    :  (goal-state T-of-ICF-i low-T-ICF ice-cube-ICF)
  ice-cube-ICF  :  (inst-of ice-cube-ICF ice-cube)
  initst-ICF-1  :  (init-state T-of-ICF-f low-T-ICF on-ICF-ig in-ICF-gf)
  initst-ICF-2  :  (init-state on-ICF-ig in-ICF-gf)
  interst-ICF   :  (inter-state in-ICF-if T-of-ICF-f fridge-ICF)
  in-ICF-if     :  (in ice-cube-ICF fridge-ICF)
  on-ICF-ig     :  (on ice-cube-ICF glass-ICF)
  in-ICF-gf     :  (in glass-ICF fridge-ICF)
  low-T-ICF     :  (inst-of low-T-ICF low-temp)
  made-of-ICF   :  (made-of glass-ICF mglass-ICF)
  mglass-ICF    :  (inst-of mglass-ICF material-glass)
  T-of-ICF-f    :  (temperature-of fridge-ICF low-T-ICF)
  T-of-ICF-i    :  (temperature-of ice-cube-ICF low-T-ICF)
  to-reach-ICF  :  (to-reach initst-ICF-1 goalst-ICF)


;;;;;;  Base sit. BPF (Butter on a Plate in a Fridge)

  sit-BPF       :  (inst-of sit-BPF situation)

  butter-BPF    :  (inst-of butter-BPF butter)
  cause-BPF-i   :  (cause initst-BPF-2 in-BPF-bf)
  cause-BPF-t   :  (cause interst-BPF  T-of-BPF-b)
  circular-BPF  :  (inst-of circular-BPF circular-shape)
  endst-BPF     :  (end-state T-of-BPF-b)
  follows-BPF   :  (follows initst-BPF-1 endst-BPF)
  fridge-BPF    :  (inst-of fridge-BPF fridge)
  goalst-BPF    :  (goal-state T-of-BPF-b low-T-BPF butter-BPF)
  initst-BPF-1  :  (init-state T-of-BPF-f low-T-BPF on-BPF in-BPF-pf)
  initst-BPF-2  :  (init-state on-BPF in-BPF-pf)
  interst-BPF   :  (inter-state in-BPF-bf T-of-BPF-f fridge-BPF)
  in-BPF-bf     :  (in butter-BPF fridge-BPF)
  in-BPF-pf     :  (in plate-BPF fridge-BPF)
  low-T-BPF     :  (inst-of low-T-BPF low-temp)
  made-of-BPF   :  (made-of plate-BPF mchina-BPF)
  mchina-BPF    :  (inst-of mchina-BPF material-china)
  on-BPF        :  (on plate-BPF butter-BPF)
  plate-BPF     :  (inst-of plate-BPF plate)
  shape-of-BPF  :  (shape-of plate-BPF circular-BPF)
  T-of-BPF-f    :  (temperature-of fridge-BPF low-T-BPF)
  T-of-BPF-b    :  (temperature-of butter-BPF low-T-BPF)   ; goal
  to-reach-BPF  :  (to-reach initst-BPF-1 goalst-BPF)


;;;;;;  Base sit STC (Sugar in Tea in a Cup)

  sit-STC        :  (inst-of sit-STC situation)

  cause-STC      :  (cause initst-STC taste-of-STC-t)
  cup-STC        :  (inst-of cup-STC cup)
  endst-STC      :  (end-state taste-of-STC-t)
  follows-STC    :  (follows initst-STC endst-STC)
  goalst-STC     :  (goal-state taste-of-STC-t sweet-STC tea-STC)
  in-STC-st      :  (in sugar-STC tea-STC)
  in-STC-tc      :  (in tea-STC cup-STC)
  initst-STC     :  (init-state taste-of-STC-s sweet-STC in-STC-st sugar-STC)
  on-STC         :  (on saucer-STC cup-STC)
  saucer-STC     :  (inst-of saucer-STC saucer)
  sugar-STC      :  (inst-of sugar-STC sugar)
  sweet-STC      :  (inst-of sweet-STC sweet-taste)
  taste-of-STC-s :  (taste-of sugar-STC sweet-STC)
  taste-of-STC-t :  (taste-of tea-STC sweet-STC)
  tea-STC        :  (inst-of tea-STC tea)
  to-reach-STC   :  (to-reach initst-STC goalst-STC)


;;;;;;  Base sit. SFF (Salt in Food in a Fridge)

  sit-SFF        :  (inst-of sit-SFF situation)

  cause-SFF-i    :  (cause initst-SFF-2 in-SFF-ff)
  cause-SFF-tmp  :  (cause interst-SFF T-of-SFF-fd)
  cause-SFF-tst  :  (cause initst-SFF-3 taste-of-SFF-f)
  endst-SFF      :  (end-state T-of-SFF-fd taste-of-SFF-f)
  follows-SFF    :  (follows initst-SFF-1 endst-SFF)
  food-SFF       :  (inst-of food-SFF food)
  fridge-SFF     :  (inst-of fridge-SFF fridge)
  goalst-SFF     :  (goal-state T-of-SFF-fd low-T-SFF food-SFF)
  in-SFF-ff      :  (in food-SFF fridge-SFF)
  in-SFF-pf      :  (in plate-SFF fridge-SFF)
  in-SFF-sf      :  (in salt-SFF food-SFF)
  initst-SFF-1   :  (init-state in-SFF-ff T-of-SFF-fr fridge
                                            in-SFF-sf T-of-SFF-fr)
  initst-SFF-2   :  (init-state on-SFF in-SFF-pf)
  initst-SFF-3   :  (init-state in-SFF-sf taste-of-SFF-s salty-SFF)
  interst-SFF    :  (inter-state in-SFF-ff T-of-SFF-fr fridge-SFF)
  low-T-SFF      :  (inst-of low-T-SFF low-temp)
  on-SFF         :  (on plate-SFF food-SFF)
  plate-SFF      :  (inst-of plate-SFF plate)
  salt-SFF       :  (inst-of salt-SFF salt)
  salty-SFF      :  (inst-of salty-SFF salt-taste)
  taste-of-SFF-s :  (taste-of salt-SFF salty-SFF)
  taste-of-SFF-f :  (taste-of food-SFF salty-SFF)
  T-of-SFF-fd    :  (temperature-of food-SFF low-T-SFF)
  T-of-SFF-fr    :  (temperature-of fridge-SFF low-T-SFF)
  to-reach-SFF   :  (to-reach initst-SFF-1 goalst-SFF)


;;;;;;  Base sit. ERW (Egg in Red Water)

  sit-ERW        :  (inst-of sit-ERW situation)

  cause-ERW      :  (cause initst-ERW  color-of-ERW-e)
  color-of-ERW-e :  (color-of egg-ERW red-ERW)
  color-of-ERW-w :  (color-of water-ERW red-ERW)
  egg-ERW        :  (inst-of egg-ERW egg)
  endst-ERW      :  (end-state color-of-ERW-e)
  follows-ERW    :  (follows initst-ERW endst-ERW)
  goalst-ERW     :  (goal-state color-of-ERW-e egg-ERW)
  in-ERW-ew      :  (in egg-ERW water-ERW)
  in-ERW-wt      :  (in water-ERW tpot-ERW)
  initst-ERW     :  (init-state color-of-ERW-w red-ERW egg-ERW in-ERW-ew)
  made-of-ERW    :  (made-of tpot-ERW mmetal-ERW)
  mmetal-ERW     :  (inst-of mmetal-ERW material-metal)
  red-ERW        :  (inst-of red-ERW red)
  to-reach-ERW   :  (to-reach initst-ERW goalst-ERW)
  tpot-ERW       :  (inst-of tpot-ERW teapot)
  water-ERW      :  (inst-of water-ERW water)


;;;;;;  Base sit. GWB (Glass in a Wooden Box)

  sit-GWB       :  (inst-of sit-GWB situation)

  box-GWB       :  (inst-of box-GWB box)
  cause-GWB     :  (cause in-GWB protects-GWB)
  endst-GWB     :  (end-state protects-GWB)
  follows-GWB   :  (follows initst-GWB endst-GWB)
  glass-GWB     :  (inst-of glass-GWB glass)
  goalst-GWB    :  (goal-state protects-GWB)
  in-GWB        :  (in glass-GWB box-GWB)
  initst-GWB    :  (init-state glass-GWB box-GWB in-GWB)
  made-of-GWB-b :  (made-of box-GWB mwood-GWB)
  made-of-GWB-g :  (made-of glass-GWB mglass-GWB)
  mglass-GWB    :  (inst-of mglass-GWB material-glass)
  mwood-GWB     :  (inst-of mwood-GWB material-wood)
  protects-GWB  :  (protects box-GWB glass-GWB)
  to-reach-GWB  :  (to-reach initst-GWB goalst-GWB)


*********************************************************************


;;;;;;  Target problem HM1  (Heating Milk, variant 1)

  sit-HM1       :  (inst-of sit-HM1 situation)

  goalst-HM1    :  (goal-state T-of-HM1 high-T-HM1)
  in-HM1        :  (in milk-HM1 tpot-HM1)
  initst-HM1    :  (init-state milk-HM1 tpot-HM1 in-HM1 made-of-HM1)
  high-T-HM1    :  (inst-of high-T-HM1 high-temp)
  made-of-HM1   :  (made-of tpot-HM1 mmetal-HM1)
  mmetal-HM1    :  (inst-of mmetal-HM1 material-metal)
  milk-HM1      :  (inst-of milk-HM1 milk)
  T-of-HM1      :  (temperature-of milk-HM1 high-T-HM1)
  to-reach-HM1  :  (to-reach initst-HM1 goalst-HM1)
  tpot-HM1      :  (inst-of tpot-HM1 teapot)


;;;;;;  Target problem HM2 (Heating Milk, variant 2)

  sit-HM2       :  (inst-of sit-HM2 situation)

  endst-HM2     :  (end-state ???)
  follows-HM2   :  (follows initst-HM2 endst-HM2)
  high-T-HM2    :  (inst-of high-T-HM2 high-temp)
  hplate-HM2    :  (inst-of hplate-HM2 hot-plate)
  in-HM2        :  (in milk-HM2 tpot-HM2)
  initst-HM2    :  (init-state hplate-HM2 on-HM2 in-HM2 T-of-HM2)
  milk-HM2      :  (inst-of milk-HM2 milk)
  on-HM2        :  (on hplate-HM2 tpot-HM2)
  T-of-HM2      :  (temperature-of hplate-HM2 high-T-HM2)
  tpot-HM2      :  (inst-of tpot-HM2 teapot)


;;;;;;  Target problem CM1  (Cooling Milk, variant 1)

  sit-CM1       :  (inst-of sit-CM1 situation)

  goalst-CM1    :  (goal-state T-of-CM1 low-T-CM1)
  in-CM1        :  (in milk-CM1 tpot-CM1)
  initst-CM1    :  (init-state milk-CM1 tpot-CM1 in-CM1 made-of-CM1)
  low-T-CM1     :  (inst-of low-T-CM1 low-temp)
  made-of-CM1   :  (made-of tpot-CM1 mmetal-CM1)
  milk-CM1      :  (inst-of milk-CM1 milk)
  mmetal-CM1    :  (inst-of mmetal-CM1 material-metal)
  T-of-CM1      :  (temperature-of milk-CM1 low-T-CM1)
  to-reach-CM1  :  (to-reach initst-CM1 goalst-CM1)
  tpot-CM1      :  (inst-of tpot-CM1 teapot)


;;;;;;  Target problem CM2  (Cooling Milk, variant 2)

  sit-CM2       :  (inst-of sit-CM2 situation)

  black-CM2     :  (inst-of black-CM2 black)
  color-of-CM2  :  (color-of tpot-CM2 black-CM2)
  goalst-CM2    :  (goal-state ???)
  to-reach-CM2  :  (to-reach initst-CM2 goalst-CM2)
  fridge-CM2    :  (inst-of fridge-CM2 fridge)
  in-CM2-mt     :  (in milk-CM2 tpot-CM2)
  in-CM2-tf     :  (in tpot-CM2 fridge-CM2)
  initst-CM2    :  (init-state fridge-CM2 in-CM2-tf in-CM2-mt T-of-CM2)
  low-T-CM2     :  (inst-of low-T-CM2 low-temp)
  milk-CM2      :  (inst-of milk-CM2 milk)
  T-of-CM2      :  (temperature-of fridge-CM2 low-T-CM2)
  tpot-CM2      :  (inst-of tpot-CM2 teapot)


;;;;;;  Target problem WB1  (Water in a wooden Bowl)

  sit-WB1       :  (inst-of sit-WB1 situation)

  bowl-WB1      :  (inst-of bowl-WB1 bowl)
  goalst-WB1    :  (goal-state T-of-WB1 high-T-WB1)
  in-WB1        :  (in water-WB1 bowl-WB1)
  initst-WB1    :  (init-state water-WB1 bowl-WB1 in-WB1 made-of-WB1)
  high-T-WB1    :  (inst-of high-T-WB1 high-temp)
  made-of-WB1   :  (made-of bowl-WB1 mwood-WB1)
  mwood-WB1     :  (inst-of mwood-WB1 material-wood)
  T-of-WB1      :  (temperature-of water-WB1 high-T-WB1)
  to-reach-WB1  :  (to-reach initst-WB1 goalst-WB1)
  water-WB1     :  (inst-of water-WB1 water)


;;;;;;  Target problem WG1  (Water in a Glass)

  sit-WG1       :  (inst-of sit-WG1 situation)

  color-of-WG1  :  (color-of glass-WG1 white-WG1)
  glass-WG1     :  (inst-of glass-WG1 glass)
  goalst-WG1    :  (goal-state T-of-WG1 high-T-WG1)
  in-WG1        :  (in water-WG1 glass-WG1)
  initst-WG1    :  (init-state water-WG1 glass-WG1 in-WG1 made-of-WG1)
  high-T-WG1    :  (inst-of high-T-WG1 high-temp)
  made-of-WG1   :  (made-of glass-WG1 mglass-WG1)
  mglass-WG1    :  (inst-of mglass-WG1 material-glass)
  T-of-WG1      :  (temperature-of water-WG1 high-T-WG1)
  to-reach-WG1  :  (to-reach initst-WG1 goalst-WG1)
  water-WG1     :  (inst-of water-WG1 water)
  white-WG1     :  (inst-of white-WG1 white)


;;;;;;  Target problem SF1  (Salty Food, variant 1)

  sit-SF1       :  (inst-of sit-SF1 situation)

  food-SF1      :  (inst-of food-SF1 food)
  goalst-SF1    :  (goal-state taste-of-SF1 salty-SF1)
  initst-SF1    :  (init-state food-SF1 plate-SF1 on-SF1 made-of-SF1)
  made-of-SF1   :  (made-of plate-SF1 mchina-SF1)
  mchina-SF1    :  (inst-of mchina-SF1 material-china)
  on-SF1        :  (on plate-SF1 food-SF1)
  plate-SF1     :  (inst-of plate-SF1 plate)
  salty-SF1     :  (inst-of salty-SF1 salt-taste)
  taste-of-SF1  :  (taste-of food-SF1 salty-SF1)
  to-reach-SF1  :  (to-reach initst-SF1 goalst-SF1)


;;;;;;  Target problem SF2  (Salty Food, variant 2)

  sit-SF2       :  (inst-of sit-SF2 situation)

  endst-SF2     :  (end-state ???)
  follows-SF2   :  (follows initst-SF2 endst-SF2)
  food-SF2      :  (inst-of food-SF2 food)
  in-SF2        :  (in salt-SF2 food-SF2)
  initst-SF2    :  (init-state salt-SF2 food-SF2 plate-SF2)
  on-SF2        :  (on plate-SF2 food-SF2)
  plate-SF2     :  (inst-of plate-SF2 plate)
  salt-SF2      :  (inst-of salt-SF2 salt)


;;;;;;  Target problem EHW  (Egg in Hot Water)

  sit-EHW       :  (inst-of sit-EHW situation)

  color-of-EHW  :  (color-of egg-EHW white-EHW)
  egg-EHW       :  (inst-of egg-EHW egg)
  endst-EHW     :  (end-state ???)
  follows-EHW   :  (follows initst-EHW endst-EHW)
  in-EHW-ew     :  (in egg-EHW water-EHW)
  in-EHW-wt     :  (in water-EHW tpot-EHW)
  initst-EHW    :  (init-state egg-EHW in-EHW-ew in-EHW-wt T-of-EHW)
  high-T-EHW    :  (inst-of high-T-EHW high-temp)
  made-of-EHW   :  (made-of tpot-EHW mmetal-EHW)
  mmetal-EHW    :  (inst-of mmetal-EHW material-metal)
  T-of-EHW      :  (temperature-of water-EHW high-T-EHW)
  tpot-EHW      :  (inst-of tpot-EHW teapot)
  water-EHW     :  (inst-of water-EHW water)
  white-EHW     :  (inst-of white-EHW white)


;;;;;;;;  Target problem ICC  (Ice Cube in Coke)
;;
;;  sit-ICC       :  (inst-of sit-ICC situation)
;;
;;  follows-ICC   :  (follows initst-ICC endst-ICC)
;;  coke-ICC      :  (inst-of coke-ICC coke)
;;  endst-ICC     :  (end-state ???)
;;  glass-ICC     :  (inst-of glass-ICC glass)
;;  ice-cube-ICC  :  (inst-of ice-cube-ICC ice-cube)
;;  in-ICC-ic     :  (in ice-cube-ICC coke-ICC)
;;  in-ICC-cg     :  (in coke-ICC glass-ICC)
;;  initst-ICC    :  (init-state ice-cube-ICC in-ICC-ic in-ICC-cg T-of-ICC)
;;  low-T-ICC     :  (inst-of low-T-ICC low-temp)
;;  made-of-ICC   :  (made-of glass-ICC mglass-ICC)
;;  mglass-ICC    :  (inst-of mglass-ICC material-glass)
;;  on-ICC        :  (on table-ICC glass-ICC)
;;  table-ICC     :  (inst-of table-ICC table)
;;  T-of-ICC      :  (temperature-of ice-cube-ICC low-T-ICC)

